#domain
hospital
#levelname
SADistanceTrap
#colors
blue: 0, A, B
#initial
+++++++++++++++++
+0      A       +
+       ++++++  +
+       +    +  +
+       + B  +  +
+       +    +  +
+       ++++++  +
+               +
+++++++++++++++++
#goal
+++++++++++++++++
+               +
+       ++++++  +
+       +    +  +
+       + A  +  +
+       +    +  +
+       ++++++  +
+        B      +
+++++++++++++++++
#end
